# Special countries..
REB = "countries/Rebels.txt"
PIR = "countries/Pirates.txt"
NAT = "countries/Natives.txt"AAC = "countries/Aachen.txt"
ABA = "countries/Alba.txt"
ABB = "countries/Dongola.txt"
ABE = "countries/Abenaki.txt"
ABI = "countries/Abihka.txt"
ACH = "countries/PrincipalityOfAchaia.txt"
ACO = "countries/Acoma.txt"
ADA = "countries/Adal.txt"
ADE = "countries/Aden.txt"
ADU = "countries/Andalusia.txt"
AEG = "countries/Aegea.txt"
AFA = "countries/Afar.txt"
AFG = "countries/Afghanistan.txt"
AGD = "countries/Argead.txt"
AGG = "countries/Attigneenongnahac.txt"
AGQ = "countries/Algonquin.txt"
AHM = "countries/Ahmadnagar.txt"
AIR = "countries/Air.txt"
AJU = "countries/Ajuuraan.txt"
AKK = "countries/AkKoyunlu.txt"
AKM = "countries/Akamatsu.txt"
AKS = "countries/Aksumite Empire.txt"
AKT = "countries/Ando.txt"
ALA = "countries/Alaska.txt"
ALB = "countries/Albania.txt"
ALC = "countries/Algeciras.txt"
ALE = "countries/Alencon.txt"
ALG = "countries/Algiers.txt"
ALH = "countries/Haasa.txt"
ALN = "countries/Alentejo.txt"
ALO = "countries/Alodia.txt"
ALS = "countries/Alsace.txt"
ALT = "countries/Altamaha.txt"
ALX = "countries/Alexandria.txt"
AMA = "countries/Amago.txt"
AMG = "countries/Armagnac.txt"
ANH = "countries/Anhalt.txt"
ANJ = "countries/Anjou.txt"
ANL = "countries/Anilco.txt"
ANN = "countries/Annam.txt"
ANS = "countries/Ansbach.txt"
ANT = "countries/Antemoro.txt"
ANU = "countries/Ainu.txt"
ANZ = "countries/Anizah.txt"
AOT = "countries/Aotearoa.txt"
APA = "countries/Apache.txt"
AQU = "countries/Aquileia.txt"
ARA = "countries/Aragon.txt"
ARB = "countries/Arabia.txt"
ARD = "countries/Ardalan.txt"
ARE = "countries/Arezzo.txt"
ARH = "countries/Arkhangelsk.txt"
ARK = "countries/Arakan.txt"
ARL = "countries/Ardabil.txt"
ARM = "countries/Armenia.txt"
ARN = "countries/Arendaronon.txt"
ARP = "countries/Arapaho.txt"
ARW = "countries/Arawak.txt"
ASA = "countries/Asakura.txt"
ASH = "countries/Ashanti.txt"
ASI = "countries/Assiniboine.txt"
ASK = "countries/Ashikaga.txt"
ASR = "countries/Assyria.txt"
ASS = "countries/Assam.txt"
AST = "countries/Astrakhan.txt"
ASU = "countries/Asturias.txt"
ATA = "countries/Atahachi.txt"
ATC = "countries/Antioch.txt"
ATH = "countries/Athens.txt"
ATJ = "countries/Atjeh.txt"
ATT = "countries/Attignawantan.txt"
ATW = "countries/Attiwandaron.txt"
AUG = "countries/Augsburg.txt"
AUS = "countries/Australia.txt"
AUV = "countries/Auvergne.txt"
AVA = "countries/Ava.txt"
AVI = "countries/Avignon.txt"
AVR = "countries/Avars.txt"
AWN = "countries/Awngthim.txt"
AYD = "countries/Aydin.txt"
AYU = "countries/Ayutthaya.txt"
AZT = "countries/Aztec.txt"
AZV = "countries/Azov.txt"
BAD = "countries/Baden.txt"
BAH = "countries/Bahmanis.txt"
BAL = "countries/Baluchistan.txt"
BAM = "countries/Bamberg.txt"
BAN = "countries/Banten.txt"
BAR = "countries/Bar.txt"
BAV = "countries/Bavaria.txt"
BDA = "countries/Baroda.txt"
BEI = "countries/Brunei.txt"
BEJ = "countries/Beja.txt"
BEM = "countries/Bemba.txt"
BEN = "countries/Benin.txt"
BER = "countries/Berry.txt"
BEU = "countries/Berau.txt"
BGA = "countries/Baglana.txt"
BGL = "countries/Bagelkhand.txt"
BHA = "countries/Bharat.txt"
BHR = "countries/Bhreadainn.txt"
BHT = "countries/Bohtan.txt"
BHU = "countries/Bhutan.txt"
BIH = "countries/Bihar.txt"
BIJ = "countries/Bijapur.txt"
BKJ = "countries/Baekje.txt"
BLA = "countries/Blackfoot.txt"
BLD = "countries/Bangladesh.txt"
BLG = "countries/Bologna.txt"
BLI = "countries/Bali.txt"
BLM = "countries/Blambangan.txt"
BLO = "countries/Beloozero.txt"
BLT = "countries/Baltii.txt"
BND = "countries/Bundelkhand.txt"
BNE = "countries/Bone.txt"
BNG = "countries/Bengal.txt"
BNJ = "countries/Banjar.txt"
BNS = "countries/BeniSuef.txt"
BNY = "countries/Bunyoro.txt"
BOH = "countries/Bohemia.txt"
BON = "countries/Bonoman.txt"
BOS = "countries/Bosnia.txt"
BOU = "countries/Bourbonnais.txt"
BPI = "countries/Biapas.txt"
BPR = "countries/Prome.txt"
BRA = "countries/Brandenburg.txt"
BRB = "countries/Brabant.txt"
BRE = "countries/Bremen.txt"
BRG = "countries/Berg.txt"
BRI = "countries/Brittany.txt"
BRR = "countries/Berar.txt"
BRS = "countries/Barus.txt"
BRT = "countries/Buryats.txt"
BRU = "countries/Brunswick.txt"
BRZ = "countries/Brazil.txt"
BSC = "countries/Brescia.txt"
BSG = "countries/Basoga.txt"
BSH = "countries/Bashkiria.txt"
BSR = "countries/Basra.txt"
BST = "countries/Bastar.txt"
BTI = "countries/Semien.txt"
BTL = "countries/Bitlis.txt"
BTN = "countries/Buton.txt"
BTS = "countries/Betsimisaraka.txt" #And their predecessors
BTU = "countries/Butuan.txt"
BUG = "countries/Buganda.txt"
BUK = "countries/Bukhara.txt"
BUL = "countries/Bulgaria.txt"
BUR = "countries/Burgundy.txt"
BUU = "countries/Burundi.txt"
BYT = "countries/Bayreuth.txt"
BYZ = "countries/ByzantineEmpire.txt"
CAB = "countries/Carib.txt"
CAD = "countries/Caddo.txt"
CAL = "countries/California.txt"
CAM = "countries/UPCA.txt"
CAN = "countries/Canada.txt"
CAO = "countries/Cahokia.txt"
CAP = "countries/Capitanata.txt"
CAQ = "countries/Casqui.txt"
CAS = "countries/Castille.txt"
CAT = "countries/Catalunya.txt"
CAY = "countries/Cayuga.txt"
CBA = "countries/Chiba.txt"
CCA = "countries/Chisca.txt"
CCM = "countries/Chichimeca.txt"
CCQ = "countries/Calchaqui.txt"
CDL = "countries/Dali.txt"
CEB = "countries/Cebu.txt"
CEP = "countries/Corfu.txt"
CEY = "countries/Ceylon.txt"
CGS = "countries/Changsheng.txt"
CHA = "countries/Champa.txt"
CHC = "countries/Chu.txt"
CHD = "countries/Chanda.txt"
CHE = "countries/Cherokee.txt"
CHG = "countries/ChagataiKhanate.txt"
CHH = "countries/Chahar.txt"
CHI = "countries/Chickasaw.txt"
CHK = "countries/Champassak.txt"
CHL = "countries/Chile.txt"
CHM = "countries/Chimu.txt"
CHN = "countries/China.txt"
CHO = "countries/Choctaw.txt"
CHP = "countries/Champagne.txt"
CHR = "countries/Chernigov.txt"
CHT = "countries/Chorti.txt"
CHU = "countries/Chukchi.txt"
CHV = "countries/Chavchuveny.txt"
CHY = "countries/Cheyenne.txt"
CIA = "countries/Chiaha.txt"
CIR = "countries/Circassia.txt"
CJA = "countries/Cajamarca.txt"
CKW = "countries/Chokwe.txt"
CLA = "countries/Colla.txt"
CLB = "countries/Calenberg.txt"
CLG = "countries/Chalahgawtha.txt"
CLI = "countries/Cilli.txt"
CLM = "countries/Colima.txt"
CMI = "countries/Miao.txt"
CMP = "countries/RewaKantha.txt"
CND = "countries/Candar.txt"
CNK = "countries/Chinook.txt"
CNN = "countries/Connacht.txt"
CNP = "countries/Can Pech.txt"
COB = "countries/Coburg.txt"
COC = "countries/Cocomes.txt"
COF = "countries/Cofitachequi.txt"
COI = "countries/Coixtlahuaca.txt"
COL = "countries/Colombia.txt"
COM = "countries/Comanche.txt"
COO = "countries/Coosa.txt"
COR = "countries/Corsica.txt"
COW = "countries/Coweta.txt"
CRA = "countries/Charca.txt"
CRB = "countries/Cirebon.txt"
CRE = "countries/Creek.txt"
CRI = "countries/Crimea.txt"
CRM = "countries/Cremona.txt"
CRN = "countries/Cornwall.txt"
CRO = "countries/Croatia.txt"
CRT = "countries/Crete.txt"
CSC = "countries/Cascadia.txt"
CSH = "countries/Shun.txt"
CSK = "countries/Chosokabe.txt"
CSU = "countries/Cusco.txt"
CTM = "countries/Chactemal.txt"
CUA = "countries/Charrua.txt"
CUB = "countries/Cuba.txt"
CUM = "countries/Cuman.txt"
CXI = "countries/Xi.txt"
CYA = "countries/Chachapoya.txt"
CYI = "countries/Yi.txt"
CYP = "countries/Cyprus.txt"
CYR = "countries/Cyrenaica.txt"
CZH = "countries/Zhou.txt"
DAH = "countries/Dahomey.txt"
DAI = "countries/DaiViet.txt"
DAL = "countries/Dalmatia.txt"
DAM = "countries/Damot.txt"
DAN = "countries/Denmark.txt"
DAR = "countries/Darfur.txt"
DAU = "countries/Dauphine.txt"
DAW = "countries/Dawasir.txt"
DEC = "countries/Deccan.txt"
DGB = "countries/Dagbon.txt"
DGL = "countries/Maldives.txt"
DHU = "countries/Dhundhar.txt"
DLH = "countries/Delhi.txt"
DLI = "countries/Deli.txt"
DMK = "countries/Demak.txt"
DMS = "countries/Desmond.txt"#Earldom of Desmond
DNG = "countries/Dang.txt"
DNZ = "countries/Danzig.txt"
DOA = "countries/Doab.txt"
DTE = "countries/Date.txt"
DTI = "countries/Doti.txt"
DTT = "countries/Dithmarschen.txt"
DUL = "countries/Dulkadir.txt"
DWT = "countries/Donauwoerth.txt"
EAL = "countries/EastAnglia.txt"
EFR = "countries/EastFrisia.txt"
EGY = "countries/Egypt.txt"
EJZ = "countries/EastJianzhou.txt"# Split from Jianzhou
ELF = "countries/Elfdalia.txt"
ENA = "countries/Eneara.txt"
ENG = "countries/England.txt"
EOR = "countries/Eora.txt"
EPI = "countries/Epirus.txt"
ERE = "countries/Eretna.txt"
ERI = "countries/Erie.txt"
ERM = "countries/EastRome.txt"
EST = "countries/Estonia.txt"
ETH = "countries/Ethiopia.txt"
ETO = "countries/Etowah.txt"
ETR = "countries/Etruria.txt"
FAD = "countries/Fadl.txt"
FAF = "countries/Fafari.txt"
FEO = "countries/Theodoro.txt"
FER = "countries/Ferrara.txt"
FEZ = "countries/Fez.txt"
FIN = "countries/Finland.txt"
FKN = "countries/Franconia.txt"
FLA = "countries/Flanders.txt"
FLO = "countries/Florida.txt"
FLY = "countries/Faly.txt"
FOI = "countries/Foix.txt"
FOX = "countries/Fox.txt"
FRA = "countries/France.txt"
FRI = "countries/Friesland.txt"
FRM = "countries/Formosa.txt"
FRN = "countries/Frankfurt.txt"
FRO = "countries/Faroes.txt"
FRS = "countries/Fars.txt"
FUL = "countries/Fulo.txt"
FZA = "countries/Fezzan.txt"
GAL = "countries/Galicia.txt"
GAM = "countries/Guamar.txt"
GAZ = "countries/Gazikumukh.txt"
GBR = "countries/GreatBritain.txt"
GDW = "countries/Gondwana.txt"
GEL = "countries/Gelre.txt"
GEN = "countries/Genoa.txt"
GEO = "countries/Georgia.txt"
GER = "countries/Germany.txt"
GHA = "countries/Ghana.txt"
GHD = "countries/Ghadames.txt"
GHR = "countries/Garhwal.txt"
GLA = "countries/Galicia_POL.txt"
GLE = "countries/Geledi.txt"
GLG = "countries/Glogau.txt"
GLH = "countries/GoldenHorde.txt"
GMI = "countries/Gamilaraay.txt"
GNG = "countries/Gingee.txt"
GNV = "countries/Geneva.txt"
GOC = "countries/Golconda.txt"
GOL = "countries/GreatHorde.txt"
GOS = "countries/Goslar.txt"
GOT = "countries/Gotland.txt"
GRA = "countries/Granada.txt"
GRE = "countries/Greece.txt"
GRJ = "countries/Garjat.txt"
GRK = "countries/Gorkha.txt"
GRM = "countries/Germiyan.txt"
GTA = "countries/Gotaland.txt"
GUA = "countries/Guarani.txt"
GUG = "countries/Guge.txt"
GUJ = "countries/Gujarat.txt"
GUR = "countries/Gurma.txt"
GUY = "countries/Gascony.txt"
GWA = "countries/Gwalior.txt"
GZI = "countries/Great Zimbabwe.txt"
HAB = "countries/Austria.txt"
HAD = "countries/Hadoti.txt"
HAI = "countries/Hainaut.txt"
HAM = "countries/Hamburg.txt"
HAN = "countries/Hannover.txt"
HAR = "countries/Harar.txt"
HAT = "countries/Haiti.txt"
HAU = "countries/Hausa.txt"
HAW = "countries/Hawaii.txt"
HDA = "countries/Haida.txt"
HDR = "countries/Hadramut.txt"
HDY = "countries/Hadiya.txt"
HED = "countries/Hedjaz.txt"
HES = "countries/Hessen.txt"
HIN = "countries/Hindustan.txt"
HJA = "countries/Huyla.txt"
HJO = "countries/Hojo.txt"
HLR = "countries/HolyRomanEmpire.txt"
HMI = "countries/Karadel.txt"
HNI = "countries/Hasinai.txt"
HNX = "countries/Habaguanex.txt"
HOB = "countries/Hobyo.txt"
HOD = "countries/Hodyntsy.txt"
HOL = "countries/Holland.txt"
HRZ = "countries/Herzegovina.txt"
HSA = "countries/Hansa.txt"
HSC = "countries/Highlands.txt"
HSE = "countries/Hsenwi.txt"
HSI = "countries/Hsipaw.txt"
HSK = "countries/Hosokawa.txt"
HSN = "countries/Ayyubids.txt"
HST = "countries/Huastec.txt"
HTK = "countries/Hatakeyama.txt"
HUA = "countries/Huai.txt"
HUN = "countries/Hungary.txt"
HUR = "countries/Huron.txt"
HWK = "countries/Hathawekela.txt"
ICE = "countries/Iceland.txt"
ICH = "countries/Ichisi.txt"
ICM = "countries/Ichma.txt"
IDR = "countries/Idar.txt"
IKE = "countries/Ikeda.txt"
ILI = "countries/Illinois.txt"
ILK = "countries/Ilkhanate.txt"
ILL = "countries/Illinewek.txt"
IME = "countries/Imereti.txt"
IMG = "countries/Imagawa.txt"
INA = "countries/Inari.txt"
INC = "countries/Inca.txt"
IND = "countries/Indrapura.txt"
ING = "countries/Ingolstadt.txt"
INN = "countries/Innu.txt"
IRE = "countries/Ireland.txt"
IRO = "countries/Iroquois.txt"
IRQ = "countries/Iraq.txt"
ISF = "countries/Isfahan.txt"
ISK = "countries/Isshiki.txt"
ISL = "countries/Isleta.txt"
ISR = "countries/Israel.txt"
ITA = "countries/Italy.txt"
ITO = "countries/Ito.txt"
ITZ = "countries/Itza.txt"
JAI = "countries/Malta.txt"
JAJ = "countries/Janjira.txt"
JAN = "countries/Jangladesh.txt"
JAP = "countries/Japan.txt"
JAR = "countries/Jarai.txt"
JFN = "countries/Jaffna.txt"
JGD = "countries/Junagarh.txt"
JIM = "countries/Jima.txt"
JIN = "countries/Jin.txt"
JJI = "countries/Janjero.txt"
JLV = "countries/Jhalavad.txt"
JMB = "countries/Jambi.txt"
JML = "countries/Jumla.txt"
JMN = "countries/Jan Mayen.txt"
JNN = "countries/Jenne.txt"
JNP = "countries/Jaunpur.txt"
JOA = "countries/Joara.txt"
JOH = "countries/Johor.txt"
JOL = "countries/Jolof.txt"
JOM = "countries/Jomsvikings.txt"
JOR = "countries/Jordan.txt"
JPR = "countries/Jeypore.txt"
JSL = "countries/Jaisalmer.txt"
JUT = "countries/Jutland.txt"
KAA = "countries/Kauai.txt"
KAC = "countries/Kachar.txt"
KAF = "countries/Kaffa.txt"
KAL = "countries/Kale.txt"
KAM = "countries/Mdokhams.txt"
KAN = "countries/Kano.txt"
KAQ = "countries/Kaqchikel.txt"
KAR = "countries/Karaman.txt"
KAS = "countries/Yarkand.txt"
KAT = "countries/Kathiawar.txt"
KAU = "countries/Kaurna.txt"
KAZ = "countries/Kazan.txt"
KBA = "countries/Kabylia.txt"
KBO = "countries/KanemBornu.txt"
KBU = "countries/Kaabu.txt"
KED = "countries/Kedah.txt"
KEL = "countries/Kelantan.txt"
KER = "countries/Keres.txt"
KGR = "countries/Kangra.txt"
KHA = "countries/MongolKhanate.txt"
KHD = "countries/Khandesh.txt"
KHI = "countries/Khiva.txt"
KHM = "countries/Khmer.txt"
KHO = "countries/Khorasan.txt"
KHR = "countries/Khorat.txt"
KIC = "countries/Kiche.txt"
KID = "countries/Kildare.txt"
KIE = "countries/Kiev.txt"
KIK = "countries/Kikondja.txt"
KIO = "countries/Kiowa.txt"
KIT = "countries/Kitara.txt"
KJH = "countries/Keonhjar.txt"
KJW = "countries/Kujawy.txt"
KKC = "countries/Kikuchi.txt"
KLD = "countries/Kalundwe.txt"
KLE = "countries/Kleves.txt"
KLH = "countries/Kalahandi.txt"
KLK = "countries/Khalkha.txt"
KLM = "countries/Kalmyk.txt"
KLN = "countries/Keladi.txt"
KLP = "countries/Kalpi.txt"
KLT = "countries/Kolathunad.txt"
KMC = "countries/Kamchadals.txt"
KMN = "countries/Kumaon.txt"
KMT = "countries/Koch.txt"
KND = "countries/Kandy.txt"
KNG = "countries/Kong.txt"
KNI = "countries/Knights.txt"
KNO = "countries/Kono.txt"
KNZ = "countries/Konstanz.txt"
KOC = "countries/Kochin.txt"
KOH = "countries/Koho.txt"
KOI = "countries/Mann.txt"
KOJ = "countries/Jerusalem.txt"
KOK = "countries/Kokkand.txt"
KOL = "countries/Cologne.txt"
KON = "countries/Kongo.txt"
KOR = "countries/Korea.txt"
KRA = "countries/Krakow.txt"
KRC = "countries/Khorchin.txt"
KRK = "countries/Carnatic.txt"
KRL = "countries/Karelia.txt"
KRM = "countries/Kerman.txt"
KRV = "countries/Karvuna.txt"
KRW = "countries/Karagwe.txt"
KRY = "countries/Gilan.txt"
KSD = "countries/Khoshuud.txt"
KSH = "countries/Kashmir.txt"
KSI = "countries/Kasihta.txt"
KSJ = "countries/Kasanje.txt"
KSK = "countries/Kaskaskia.txt"
KSP = "countries/Kispoko.txt"
KTB = "countries/Kitabatake.txt"
KTS = "countries/Katsina.txt"
KTU = "countries/Kathmandu.txt"
KUB = "countries/Kuba.txt"
KUL = "countries/Kulin.txt"
KUR = "countries/Kurland.txt"
KUS = "countries/Kush.txt"
KUT = "countries/Kutai.txt"
KZB = "countries/Kazembe.txt"
KZH = "countries/Kazakh.txt"
LAC = "countries/Lacandon.txt"
LAI = "countries/Lau.txt"
LAK = "countries/Lakota.txt"
LAN = "countries/Florence.txt"
LAP = "countries/LaPlata.txt"
LAR = "countries/Larrakia.txt"
LAU = "countries/Lauenburg.txt"
LBV = "countries/Landshut.txt"
LDK = "countries/Ladakh.txt"
LDU = "countries/Lundu.txt"
LEB = "countries/Lebanon.txt"
LEI = "countries/Leinster.txt"
LEN = "countries/Lenape.txt"
LFA = "countries/Lanfang.txt"
LIB = "countries/Libertatia.txt"
LIC = "countries/Li.txt"
LIE = "countries/Liege.txt"
LIG = "countries/Ligor.txt"
LIP = "countries/Lipan.txt"
LIT = "countries/Lithuania.txt"
LIV = "countries/LivonianOrder.txt"
LKN = "countries/Lakhnor.txt"
LNA = "countries/LanNa.txt"
LND = "countries/Lunda.txt"
LNG = "countries/Liang.txt"
LNO = "countries/Lanao.txt"
LOA = "countries/Loango.txt"
LOD = "countries/London.txt"
LOI = "countries/TheIsles.txt"
LON = "countries/Leon.txt"
LOR = "countries/Lorraine.txt"
LOT = "countries/Lotharingia.txt"
LOU = "countries/Louisiana.txt"
LPP = "countries/Lippe.txt"
LRI = "countries/Luristan.txt"
LRS = "countries/Larestan.txt"
LUA = "countries/LuangPrabang.txt"
LUB = "countries/Luba.txt"
LUC = "countries/Lucca.txt"
LUL = "countries/Lule.txt"
LUN = "countries/Luneburg.txt"
LUW = "countries/Luwu.txt"
LUX = "countries/Luxembourg.txt"
LVA = "countries/Livonia.txt"
LWA = "countries/Limbuwan.txt"
LXA = "countries/LanXang.txt"
MAA = "countries/Mataatua.txt"
MAB = "countries/Malabar.txt"
MAC = "countries/Macedonia.txt"
MAD = "countries/Madurai.txt"
MAE = "countries/Maeda.txt"
MAG = "countries/Magdeburg.txt"
MAH = "countries/Mahican.txt"
MAI = "countries/Mainz.txt"
MAJ = "countries/Majapahit.txt"
MAK = "countries/Makuria.txt"
MAL = "countries/Mali.txt"
MAM = "countries/Burgi.txt"
MAN = "countries/Mantua.txt"
MAR = "countries/Marathas.txt"
MAS = "countries/Madyaas.txt"
MAT = "countries/Matlatzinca.txt"
MAU = "countries/Maui.txt"
MAW = "countries/Marwar.txt"
MAY = "countries/Maya.txt"
MAZ = "countries/Mazovia.txt"
MBA = "countries/Mombasa.txt"
MBL = "countries/Bishnupur.txt"
MBZ = "countries/Montfort-Bregenz.txt"
MCA = "countries/Muisca.txt"
MCH = "countries/Manchu.txt"
MCM = "countries/MacCarthy.txt" #Kingdom of Desmond
MCN = "countries/Macaronesia.txt"
MDA = "countries/Medina.txt"
MDI = "countries/Mogadishu.txt"
MED = "countries/Medri Bahri.txt"
MEI = "countries/Meissen.txt"
MEK = "countries/Mekong.txt"
MEM = "countries/Memmingen.txt"
MEN = "countries/Mentese.txt"
MER = "countries/Mewar.txt"
MEW = "countries/Mewat.txt"
MEX = "countries/Mexico.txt"
MFA = "countries/Montferrat.txt"
MFL = "countries/Mikhlaf.txt"
MFY = "countries/Mahafaly.txt"
MGD = "countries/Maguindanao.txt"
MGE = "countries/MongolEmpire.txt"
MGR = "countries/Maregh.txt"
MHR = "countries/Mahra.txt"
MHX = "countries/Haixi.txt"
MIA = "countries/Mianjin.txt"
MIK = "countries/Mikmaq.txt"
MIN = "countries/Min.txt"
MIR = "countries/Merina.txt" #And Betsileo
MIS = "countries/Miskito.txt"
MIX = "countries/Mixtec.txt"
MJE = "countries/Majeerteen.txt"
MJO = "countries/Majorca.txt"
MJZ = "countries/Jianzhou.txt"
MKA = "countries/MongKawng.txt"
MKL = "countries/Mecklenburg.txt"
MKP = "countries/Makwanpur.txt"
MKS = "countries/Makassar.txt"
MKU = "countries/Makua.txt"
MLB = "countries/Manipur.txt"
MLC = "countries/Malacca.txt"
MLG = "countries/Malagana.txt"
MLH = "countries/Mulhouse.txt"
MLI = "countries/Malindi.txt"
MLK = "countries/Kashen.txt"
MLO = "countries/Milan.txt"
MLS = "countries/Maliseet.txt"
MLW = "countries/Malwa.txt"
MMA = "countries/MongMao.txt"
MMI = "countries/Miami.txt"
MML = "countries/Memel.txt"
MNA = "countries/Maynila.txt"
MNG = "countries/Ming.txt"
MNI = "countries/MongNai.txt"
MNS = "countries/IRE_Munster.txt"
MOD = "countries/Modena.txt"
MOE = "countries/Morea.txt"
MOH = "countries/Mohawk.txt"
MOL = "countries/Moldavia.txt"
MON = "countries/Montenegro.txt"
MOR = "countries/Morocco.txt"
MOS = "countries/Muscowy.txt"
MPA = "countries/MongPai.txt"
MPC = "countries/Mapuche.txt"
MPH = "countries/MuanPhuang.txt"
MPK = "countries/Malopolska.txt"
MRA = "countries/Maravi.txt"
MRC = "countries/Mercia.txt"
MRE = "countries/Marehan.txt"
MRI = "countries/Mori.txt"
MRK = "countries/Marrakesh.txt"
MRL = "countries/Markland.txt"
MSA = "countries/Malaya.txt"
MSC = "countries/Mescalero.txt"
MSG = "countries/Mississage.txt"
MSI = "countries/Mossi.txt"
MSY = "countries/Mushashaiyyah.txt"
MTH = "countries/Meath.txt"
MTR = "countries/Mataram.txt"
MUG = "countries/Mughal.txt"
MUL = "countries/Multan.txt"
MUN = "countries/Munster.txt"
MVA = "countries/Moravia.txt"
MYA = "countries/MongYang.txt"
MYR = "countries/Yeren.txt"
MYS = "countries/Mysore.txt"
MZB = "countries/Mzab.txt"
MZQ = "countries/Mozambique.txt"
NAG = "countries/Nagpur.txt"
NAH = "countries/Navajo.txt"
NAJ = "countries/Najd.txt"
NAK = "countries/Nakawe.txt"
NAP = "countries/Naples.txt"
NAV = "countries/Navarra.txt"
NAX = "countries/Naxos.txt"
NBI = "countries/Nubia.txt"
NDO = "countries/Ndongo.txt"
NED = "countries/Netherlands.txt"
NEH = "countries/Nehiyaw.txt"
NEU = "countries/Neumark.txt"
NEV = "countries/Nevers.txt"
NGA = "countries/Nagaur.txt"
NGP = "countries/Jharkhand.txt"
NHX = "countries/NorthHaixi.txt"# Split from Haixi
NIC = "countries/Nice.txt"
NJR = "countries/Najran.txt"
NKO = "countries/Nkore.txt"
NKR = "countries/Goguryeo.txt"
NNG = "countries/Ning.txt"
NOG = "countries/Nogai.txt"
NOL = "countries/Northumberland.txt"
NOO = "countries/Noongar.txt"
NOR = "countries/Norway.txt"
NOV = "countries/Novgorod.txt"
NPH = "countries/Adonisos.txt"
NPL = "countries/Nepal.txt"
NRG = "countries/Noregr.txt"
NRM = "countries/Normandy.txt"
NSA = "countries/Nassau.txt"
NSS = "countries/New Providence.txt"
NTC = "countries/Natchitoches.txt"
NTZ = "countries/Natchez.txt"
NUB = "countries/Funj.txt"
NUM = "countries/Nuremberg.txt"
NUP = "countries/Nupe.txt"
NVK = "countries/Nivkh.txt"# Split from Yeren
NVR = "countries/Navanagar.txt"
NZH = "countries/NizhnyNovgorod.txt"
NZL = "countries/Zealandia.txt"
OAH = "countries/Oahu.txt"
OBO = "countries/Obotritia.txt"
ODA = "countries/Oda.txt"
ODH = "countries/Oudh.txt"
OEO = "countries/Oneota.txt"
OGD = "countries/Ogaadeen.txt"
OGS = "countries/Ogasawara.txt"
OHK = "countries/Ohkay Owingeh.txt"
OIR = "countries/OiratHorde.txt"
OJI = "countries/Ojibwa.txt"
OKA = "countries/Oka.txt"
OKN = "countries/Orkney.txt"
OLD = "countries/Oldenburg.txt"
OMA = "countries/Oman.txt"
ONE = "countries/Oneida.txt"
ONO = "countries/Onondaga.txt"
OPL = "countries/Opole.txt"
ORD = "countries/Ormond.txt"
ORI = "countries/Orissa.txt"
ORL = "countries/Orleans.txt"
ORM = "countries/Ormuz.txt"
ORO = "countries/Oromo.txt"
OSA = "countries/Osage.txt"
OSH = "countries/Osheaga.txt"
OSM = "countries/Osman.txt"
OSN = "countries/Osnabruck.txt"
OTM = "countries/Otomo.txt"
OTO = "countries/Otomi.txt"
OTT = "countries/Ottawa.txt"
OUC = "countries/Ouchi.txt"
OYO = "countries/Oyo.txt"
PAD = "countries/Paderborn.txt"
PAH = "countries/Pahang.txt"
PAL = "countries/Palatinate.txt"
PAN = "countries/Panna.txt"
PAP = "countries/Papal.txt"
PAR = "countries/Parma.txt"
PAT = "countries/Pattani.txt"
PAV = "countries/Pavia.txt"
PAW = "countries/Pawnee.txt"
PCH = "countries/Pacaha.txt"
PCJ = "countries/Pacajes.txt"
PDV = "countries/Padova.txt"
PEG = "countries/Pegu.txt"
PEN = "countries/Penobscot.txt"
PEO = "countries/Peoria.txt"
PEQ = "countries/Pequot.txt"
PER = "countries/Persia.txt"
PEU = "countries/Peru.txt"
PGA = "countries/Perugia.txt"
PGR = "countries/Pagarruyung.txt"
PGS = "countries/Pangasinan.txt"
PHA = "countries/Phagmodrupa.txt"
PIC = "countries/Picardy.txt"
PIM = "countries/Pima.txt"
PIS = "countries/Pisa.txt"
PLB = "countries/Palembang.txt"
PLC = "countries/TheCommonwealth.txt"
PLT = "countries/Polotsk.txt"
PLW = "countries/Palawa.txt"
POI = "countries/Poitou.txt"
POL = "countries/Poland.txt"
POM = "countries/Pommerania.txt"
PON = "countries/Pontus.txt"
POR = "countries/Portugal.txt"
POT = "countries/Potawatomi.txt"
POW = "countries/Powhatan.txt"
PRB = "countries/Porbandar.txt"
PRD = "countries/Parlakhimidi.txt"
PRG = "countries/Paraguay.txt"
PRK = "countries/Perak.txt"
PRM = "countries/Perm.txt"
PRO = "countries/Provence.txt"
PRS = "countries/Paris.txt"
PRU = "countries/Prussia.txt"
PRY = "countries/Port Royal.txt"
PSA = "countries/Pasai.txt"
PSK = "countries/Pskov.txt"
PSS = "countries/Passau.txt"
PTA = "countries/Patiala.txt"
PTE = "countries/Pate.txt"
PTG = "countries/Potiguara.txt"
PTL = "countries/Palitana.txt"
PTT = "countries/Patna.txt"
PUE = "countries/Pueblo.txt"
PUN = "countries/Punjab.txt"
QAR = "countries/QaraKoyunlu.txt"
QAS = "countries/QasimKhanate.txt"
QIC = "countries/Qi.txt"
QIN = "countries/Qin.txt"
QNG = "countries/Qing.txt"
QOM = "countries/Qom.txt"
QTO = "countries/Quito.txt"
QUE = "countries/Quebec.txt"
QUI = "countries/Quizquiz.txt"
RAG = "countries/Ragusa.txt"
RAM = "countries/Ramazan.txt"
RAS = "countries/Rassids.txt"
RAV = "countries/Ravenna.txt"
REG = "countries/Regensburg.txt"
RFR = "countries/Nanbu.txt"
RHA = "countries/Rhade.txt"
RIE = "countries/Trieste.txt"
RIG = "countries/Riga.txt"
RJK = "countries/Rajkot.txt"
RJP = "countries/Rajputana.txt"
RMN = "countries/Romania.txt"
RMP = "countries/Rohilkandh.txt"
ROM = "countries/RomanEmpire.txt"
ROT = "countries/Rothenburg.txt"
RSO = "countries/Rostov.txt"
RTT = "countries/Ratanpur.txt"
RUG = "countries/Rugen.txt"
RUM = "countries/Rum.txt"
RUP = "countries/Ruppin.txt"
RUS = "countries/Russia.txt"
RVA = "countries/Ravensburg.txt"
RWA = "countries/Rwanda.txt"
RYA = "countries/Ryazan.txt"
RYU = "countries/Ryukyu.txt"
RZI = "countries/Rozwi.txt"
RZW = "countries/Butua.txt"
SAA = "countries/South Africa.txt"
SAI = "countries/Saidi.txt"
SAK = "countries/Siak.txt"
SAL = "countries/Salish.txt"
SAM = "countries/Samoa.txt"
SAR = "countries/Sardinia.txt"
SAT = "countries/Satapo.txt"
SAV = "countries/Savoy.txt"
SAX = "countries/Saxony.txt"
SBA = "countries/Shiba.txt"
SBP = "countries/Sambalpur.txt"
SCA = "countries/Scandinavia.txt"
SCN = "countries/Scania.txt"
SCO = "countries/Scotland.txt"
SDY = "countries/Sadiya.txt"
SEN = "countries/Seneca.txt"
SER = "countries/Serbia.txt"
SEV = "countries/Sevilla.txt"
SFA = "countries/SofalaSwa.txt"
SHA = "countries/Shawnee.txt"
SHL = "countries/Holstein.txt"
SHM = "countries/Shammar.txt"
SHN = "countries/Shoni.txt"
SHO = "countries/Shoshone.txt"
SHR = "countries/Sharjah.txt"
SHU = "countries/Shu.txt"
SHY = "countries/Shaybanid.txt"
SIA = "countries/Siam.txt"
SIB = "countries/Sibir.txt"
SIC = "countries/Sicily.txt"
SIE = "countries/Siena.txt"
SIL = "countries/Silesia.txt"
SIN = "countries/Singapura.txt"
SIO = "countries/Sioux.txt"
SIS = "countries/Sistan.txt"
SKA = "countries/Sakalava.txt" #All Sakalava Kingdoms
SKD = "countries/Sukanda.txt"
SKJ = "countries/Skopje.txt"
SKK = "countries/Sikkim.txt"
SKR = "countries/Silla.txt"
SLE = "countries/Sale.txt"
SLN = "countries/Sligo.txt"
SLO = "countries/Slovakia.txt"
SLZ = "countries/Salzburg.txt"
SMB = "countries/Sambas.txt"
SME = "countries/Samtskhe.txt"
SMG = "countries/Samogitia.txt"
SMI = "countries/Sami.txt"
SMO = "countries/Smolensk.txt"
SMT = "countries/Ter.txt"
SMZ = "countries/Shimazu.txt"
SNA = "countries/Sonora.txt"
SND = "countries/Sind.txt"
SOA = "countries/Shewa.txt"
SOF = "countries/Sofala.txt"
SOK = "countries/Sokoto.txt"
SOL = "countries/Solon.txt"# Split from Yeren
SOM = "countries/Somalia.txt"
SON = "countries/Songhai.txt"
SOO = "countries/So.txt"# Japanese potential pirate daimyo
SOR = "countries/Sorbia.txt"
SOS = "countries/Sus.txt"
SPA = "countries/Spain.txt"
SPI = "countries/SardiniaPiedmont.txt"
SPL = "countries/Spoleto.txt"
SRG = "countries/Surguja.txt"
SRH = "countries/Sirhind.txt"
SRM = "countries/Sirmur.txt"
SRT = "countries/Saratov.txt"
SRU = "countries/Saruhan.txt"
SRV = "countries/Shirvanshah.txt"
SSI = "countries/Massai.txt"
SST = "countries/Shan.txt"
STA = "countries/Stadacona.txt"
STE = "countries/Stettin.txt"
STK = "countries/Satake.txt"
STY = "countries/Styria.txt"
SUD = "countries/Sudetenland.txt"
SUK = "countries/Sukhothai.txt"
SUL = "countries/Sulu.txt"
SUN = "countries/Sunda.txt"
SUS = "countries/Susquehannock.txt"
SVJ = "countries/Svidjod.txt"
SWA = "countries/Swabia.txt"
SWE = "countries/Sweden.txt"
SWI = "countries/Schweiz.txt"
SYG = "countries/Sarigyogir.txt"
SYN = "countries/Synthetics.txt"
SYO = "countries/Soyo.txt"
SYR = "countries/Syria.txt"
SZO = "countries/Saluzzo.txt"
TAB = "countries/Tabarestan.txt"
TAH = "countries/Tahontaenrat.txt"
TAI = "countries/Tairona.txt"
TAK = "countries/Takitimu.txt"
TAN = "countries/Tainui.txt"
TAR = "countries/Tarascan.txt"
TAU = "countries/Taungu.txt"
TBK = "countries/Tumbuka.txt"
TBR = "countries/Tabriz.txt"
TBU = "countries/Tabruk.txt"
TDO = "countries/Tondo.txt"
TEA = "countries/TeArawa.txt"
TEN = "countries/Tenkodogo.txt"
TEO = "countries/Teotitlan.txt"
TER = "countries/Ternate.txt"
TET = "countries/Tetouan.txt"
TEU = "countries/Teutonicorder.txt"
TEX = "countries/Texas.txt"
TFL = "countries/Tafilalt.txt"
TGT = "countries/Touggourt.txt"
THU = "countries/Thuringia.txt"
TIB = "countries/Tibet.txt"
TID = "countries/Tidore.txt"
TIM = "countries/Timurid.txt"
TIO = "countries/Tionontate.txt"
TIR = "countries/Tirol.txt"
TIW = "countries/Tiwi.txt"
TKD = "countries/Takeda.txt"
TKG = "countries/Tokugawa.txt"
TKI = "countries/Toki.txt"
TKT = "countries/KnightTemplars.txt"
TLA = "countries/Tlapanec.txt"
TLC = "countries/Tlemcen.txt"
TLG = "countries/Telingana.txt"
TLX = "countries/Tlaxcala.txt"
TMB = "countries/Timbuktu.txt"
TNG = "countries/Tang.txt"
TNJ = "countries/Tanjore.txt"
TNK = "countries/Taranaki.txt"
TNT = "countries/Trent.txt"
TOG = "countries/Tonga.txt"
TOK = "countries/Tonkin.txt"
TOL = "countries/Toledo.txt"
TON = "countries/Tonallan.txt"
TOR = "countries/Tortuga.txt"
TOT = "countries/Totonac.txt"
TOU = "countries/Toulouse.txt"
TPA = "countries/Tupinamba.txt"
TPQ = "countries/Tupiniquim.txt"
TPR = "countries/Tripura.txt"
TRA = "countries/Transylvania.txt"
TRE = "countries/Trebizond.txt"
TRI = "countries/Trier.txt"
TRK = "countries/Turkana.txt"
TRP = "countries/Tripoli.txt"
TRS = "countries/Transoxiana.txt"
TRT = "countries/Tirhut.txt"
TRY = "countries/Tyrconnell.txt"
TSC = "countries/Tuscarora.txt"
TTI = "countries/Tsutsui.txt"
TTL = "countries/Three Leagues.txt"
TTS = "countries/Two Sicilies.txt"
TTT = "countries/TeTaiTokerau.txt"
TUA = "countries/Tapuia.txt"
TUN = "countries/Tunisia.txt"
TUR = "countries/Ottomans.txt"
TUS = "countries/Tuscany.txt"
TUV = "countries/Tuva.txt"
TVE = "countries/Tver.txt"
TVP = "countries/Turov-Pinsk.txt"
TYO = "countries/Tyo.txt"
TYR = "countries/Tyrone.txt"
UBH = "countries/Buha.txt"
UBV = "countries/Munich.txt"
UES = "countries/Uesugi.txt"
UHW = "countries/HawaiiUnited.txt"
UKR = "countries/Ukraine.txt"
ULM = "countries/Ulm.txt"
ULS = "countries/Ulster.txt"
URB = "countries/Urbino.txt"
USA = "countries/USA.txt"
UTN = "countries/Utsunomiya.txt"
UTR = "countries/Utrecht.txt"
UTS = "countries/Utsang.txt"
VAL = "countries/Valencia.txt"
VAN = "countries/Vandals.txt"
VEN = "countries/Venice.txt"
VER = "countries/Verden.txt"
VGO = "countries/VarangianOrder.txt"
VGT = "countries/Visigoths.txt"
VIE = "countries/Vientiane.txt"
VIJ = "countries/Vijaynagara.txt"
VIL = "countries/Viti Levu.txt"
VIN = "countries/Vinland.txt"
VIT = "countries/Viti.txt"
VLG = "countries/Vologda.txt"
VLH = "countries/Volhynia.txt"
VND = "countries/Venad.txt"
VNL = "countries/Vanua Levu.txt"
VNZ = "countries/Venezuela.txt"
VOL = "countries/Volyn.txt"
VRM = "countries/Vermont.txt"
VRN = "countries/Verona.txt"
WAD = "countries/Wadai.txt"
WAI = "countries/Waitaha.txt"
WAL = "countries/Wallachia.txt"
WAM = "countries/Wampanoag.txt"
WAR = "countries/Warsangali.txt"
WBG = "countries/Wurzburg.txt"
WCR = "countries/Cree.txt"
WCY = "countries/Wichiyena.txt"
WEN = "countries/Wenro.txt"
WES = "countries/Westfalia.txt"
WGD = "countries/Wagadugu.txt"
WIC = "countries/Wichita.txt"
WKA = "countries/Wanka.txt"
WLS = "countries/Wales.txt"
WLY = "countries/Welayta.txt"
WOL = "countries/Wolgast.txt"
WPK = "countries/Wielkopolska.txt"
WRM = "countries/WestRome.txt"
WRU = "countries/Wurundjeri.txt"
WSI = "countries/WestIndies.txt"
WSX = "countries/Wessex.txt"
WUR = "countries/Wurttemberg.txt"
WUU = "countries/Wu.txt"
XAL = "countries/Xalisco.txt"
XIU = "countries/Xiu.txt"
YAK = "countries/Yaka.txt"
YAN = "countries/Yan.txt"
YAO = "countries/Yao.txt"
YAQ = "countries/Yaqui.txt"
YAR = "countries/Yaroslavl.txt"
YAS = "countries/Yas.txt"
YAT = "countries/Yatenga.txt"
YEM = "countries/Yemen.txt"
YKT = "countries/Yokuts.txt"
YMN = "countries/Yamana.txt"
YNU = "countries/Yanuwa.txt"
YOK = "countries/Yokotan.txt"
YOL = "countries/Yolngu.txt"
YOR = "countries/Andhra.txt"
YUA = "countries/GreatYuan.txt"
YUE = "countries/Yue.txt"
YZD = "countries/Yazd.txt"
ZAF = "countries/Zafunu.txt"
ZAN = "countries/Swahili.txt"
ZAP = "countries/Zapotec.txt"
ZAZ = "countries/Zaporozhie.txt"
ZEA = "countries/Zealand.txt"
ZIM = "countries/Mutapa.txt"
ZNB = "countries/Zunbil.txt"
ZND = "countries/Zandoma.txt"
ZNI = "countries/Zuni.txt"
ZUL = "countries/Zulu.txt"
ZUN = "countries/Zunghar.txt"
ZZZ = "countries/Zazzau.txt"